44,60,64,64,2770,1900
XXXXXXXXXXXXXXXXXXXXXXXXXXXXXXXXXXXXXXXXXXXX
XXXXXXXXXXXXXXXXXXXXXXXXXXXXXXXXXXXXXXXXXXXX
XXXXXXXXXXXXXXXXXXXXOOOOOOOOOOOXXXXXXXXXXXXX
XXXXXXXXXXXXXXXXXXXOOOOOOOOOOOOXXXXXXXXXXXXX
XXXXXXXXXXXXXXXXXXOOOOOOOOOOOOOOXXXXXXXXXXXX
XXXXXXXXXXXXXXXXOOOOOOOOOOOOOOOXXXXXXXXXXXXX
XXXXXXXXXXXXXXXXOOOOOOOOOOOOOOOXXXXXXXXXXXXX
XXXXXXXXXXXXXXXOOOOOOOOOOOOoOOXXXXOXXXOOXXXX
XXXXXXXXXXXXXXXOOOOOOOOOOOOooOXXXXOOOXOOOXXX
XXXXXXXXXXXXXXXOOOOOOOOOOOOoOXXXXOOOOOOOXXXX
XXXXXXXXXXXXXXXXOOOOOOOOOOOooOXXXOOOOOOOOXXX
XXXXXXXXXXXXXXXOOOOOOOOOOOoooXXXXOOOOOOOXOXX
XXXXXXXXXXXXXXXOOOOOOOOOOOOooXXXXXOOOOOOOOOX
XXXXXXXXXXXXXXOOOOOOOOOOOOOoOXXXXXOOOOOOOOOX
XXXXXXXXXXXXXXXOOOOOOOOOOOOOOOXXXXOOOOOOOOOX
XXXXXXXXXXXXXXOOOOOOOOOOOOOOOXXXXOOOOOOOOOOX
XXXXXXXXXXXXXXOOOOOOOOOOOOOOOXXXXOOOOOOOOOOX
XXXXXXXXXXXXXOOOOOOOOOOOOOOXXXXXOOOOOOOOOOOX
XXXXXXXXXOXXXXOOOOOOOOOOOOOXXXXXOOOOOOOOOOOX
XXXXXXXXOOXXXOoOOOOOXXXOOOXXXXXXOOOOOOOOOOOX
XXXXXXOXOOOXXOoooOOOXXXXOOXXXXXXXOOOOOOOOOOX
XXOOOOOOOOOXOOooooOXXXXXOXXXXXXXXOOOOOOOOOXX
XXOOOOOOOOOOOOooooXXXOOXXXXXXXXXXXOOOOOOOOXX
XOOOOOOOOOOOOooooXXXOOOXXXXXXXXOXOOOOOOOOXXX
XOOOOOOOOOOoOOoOOXXXOoOOXXXXXXXOOOOOOXOOOXXX
XOOOOOOOOOooOOOOOXXOooOXXXXXXOOOOOOOXXOOXXXX
XOOOOOOOOOXooOOOOOOOOXoOOXXXXOOOOOOXXXXXXXXX
XOOOOOOOOXXooOOOOOOOXXOOOXOOOOOOOOOXXXXXXXXX
XOOOOOOXXXXXooOOOOOOOXOOOOOOOOOOOOOXXXXXXXXX
XOOOOOXXXXXXXOOOOOOOOOOOOOOOOOXXXXXXXXXXXXXX
XOOOOOOXXXXXXOOoOOOOOOOOOOOoOOXXXXXXXXXXXXXX
XOOOOOOXXXXXOOOoOOOOOOOOOOooOOXXXXXXXXXXXXXX
XXOOOOOXXXXOOOOXoOOOOOOOOOOXOOOXXOXXXXXXXXXX
XOOOOOXXXXOOOOXXOOOOOOOOOOXXOOOOOOXXXXXXXXXX
XOOOOOXXXXoOOOOXOOOOOOOOOOOXOOOOOOXXXXXXXXXX
XOOOOOXXXXooOOOOOOOOOOOOOOOOOOOOOXXXXXXXXXXX
XXOOOOOXXXXooOOOOOOOOoOOOOOOOOOOXXXXXXXXXXXX
XXOOOOXXXXXoooOOOOOOooOOOOOOOOOXXXXXXXXXXXXX
XXXOOOXXXXXXoooOOOOOOXoOOOOOOOOOXXXXXXXXXXXX
XXXOOXXXXXXooooOOOOOXXOOOOOOOOOOXXXXXXXXXXXX
XXXXOXXXXXXoooooOooooXOOOOOOOOOOOXXXXXXXXXXX
XXXXXXXXXXoooooooooooOOOOOXOOOOOOXXXXXXXXXXX
XXXXXXXXXXoooOooooooooOOOXXXOOOOOOXXXXXXXXXX
XXXXXXXXXXooOOooooooooOOXXXXOOOOOOXXOOXXXXXX
XXXXXXXXXXoooOOooooXXooOXXXXXXOOOOOXOOOXXXXX
XXXXXXXXXOooOOOoooXXXXoXXXXXXXOOOOOOOOOXXXXX
XXXXXXXXXOOoOoOoooXXXXXXXXXXXXXOOOOOOOOOXXXX
XXXXXXXXOOOOoooooOXXXXXXXXXXXXXOOOOOOOOOXXXX
XXXXXXOXOOOOoooooOOXXXXXXXXXXXXXOOOOOOOOOXXX
XXXXXOOOOOOoooooOOOXXXXXXXXXXXXXOOOXXOOOOOXX
XXXXOOOOOOOoooooOOOOXXXXXXXXXXXXXOXXXXOOOOOX
XOOOOOOOOOOooooOOOOOXXXXXXXXXXXXXXXXXXOOOOOX
XOOOOOOOOOOOoXoOOOOOXXXXXXXXXXXXXXXXXXXXOOOX
XOOOOOOOOOOOXXOOOOOXXXXXXXXXXXXXXXXXXXXXOOOX
XOOOOOOOOOOOOXOOOOOXXXXXXXXXXXXXXXXXXXXXXOOX
XOOOOOOOOOOOOOOOOOXXXXXXXXXXXXXXXXXXXXXXXOOX
XOOOOOOOOOOOOOOOOOXXXXXXXXXXXXXXXXXXXXXXXOOX
XOOOOOOOOOOOOOOOOXXXXXXXXXXXXXXXXXXXXXXXXOOX
XXXXXXXXXXXXXXXXXXXXXXXXXXXXXXXXXXXXXXXXXXXX
XXXXXXXXXXXXXXXXXXXXXXXXXXXXXXXXXXXXXXXXXXXX
